A violent storm rages outside. POLICE REPORT (confidential): Mr. Blackwood, a wealthy businessman, has been murdered. The crime took place inside his house. Several people were present at the time of the incident. Your task is to uncover the truth.

Murder Mystery
An Interactive Fiction by Luka Hrupec
Release 1 / Serial number 251228 / Inform 7 v10.1.2 / D

Entrance Hall
You are standing in the entrance hall of the house. Doors lead to rooms on both sides of the corridor, and a staircase at the far end leads down to the basement.

>down
You have entered the Basement.

>look
Basement
The basement is cold and dim. Cardboard boxes are stacked against the walls, and pipes run along the ceiling. A fuse box is mounted on the wall.

You can see a fuse box here.

>examine pipes
Old metal pipes carrying water through the house.

>exaime boxes
That's not a verb I recognise.

>examine boxes
Old cardboard boxes filled with Christmas decorations.

>examine fuse box
A metal fuse box controlling the electricity in the house.

The fuse box is currently switched on.

>switch off fuse box
You switch off the fuse box. The lights in the house go out.

>switch on fuse box
You switch the fuse box back on. The lights in the house return.

* * *

>look
Basement
The basement is cold and dim. Cardboard boxes are stacked against the walls, and pipes run along the ceiling. A fuse box is mounted on the wall.

You can see a fuse box here.

>up
You have entered the Entrance Hall.

>north
You have entered the Kitchen.

>look
Kitchen
The kitchen looks disturbed. Edward Blackwood lies motionless on the floor, a knife stuck in his back. You notice a refrigerator, an oven, a kitchen table, spice cabinets and a knife rack on the wall.

* * *

>down
You have entered the Basement.

>switch off fuse box
You switch off the fuse box. The lights in the house go out.

>up
It's too dark to see the stairs. You might fall if you try to go up.

>switch on fuse box
You switch the fuse box back on. The lights in the house return.

>up
You have entered the Entrance Hall.

* * *

>down
You have entered the Basement.

>switch off fusebox
You can't see any such thing.

>switch off fuse box
You switch off the fuse box. The lights in the house go out.

* * *

>down
You have entered the Basement.

>up
You have entered the Entrance Hall.

>down
You have entered the Basement.

* * *

>up
You have entered the Entrance Hall.

>east
You have entered the Bedroom.

>look
Bedroom
The bedroom is neat and carefully arranged. A bed stands in the center, with a nightstand beside it and a large wardrobe against the wall.

You can see a nightstand (closed) and a wardrobe (closed) here.

>west
You have entered the Entrance Hall.

* * *

A violent storm rages outside. POLICE REPORT (confidential): Mr. Blackwood, a wealthy businessman, has been murdered. The crime took place inside his house. Several people were present at the time of the incident. Your task is to uncover the truth.

Murder Mystery
An Interactive Fiction by Luka Hrupec
Release 1 / Serial number 251228 / Inform 7 v10.1.2 / D

Entrance Hall
You are standing in the entrance hall of the house. Doors lead to rooms on both sides of the corridor, and a staircase at the far end leads down to the basement.

>east
You have entered the Bedroom.

>ask son about safe
He shakes his head impatiently. "That doesn't matter."

>examine wardrobe
A large wardrobe filled with expensive clothes.

As you examine the wardrobe more carefully, you notice a suspicious false bottom.

>examine bottom
A suspicious removable panel at the bottom of the wardrobe.

Behind the false bottom, you discover a small locked safe.

>examine safe
A small metal safe hidden behind the false bottom.

>ask son about safe
His eyes narrow. "I knew he was hiding something," he says. "Money. Documents. Something important. He never trusted anyone enough to say what it really was."

* * *

>east
You have entered the Bedroom.

>examine wardrobe
A large closed wardrobe.

>examin bottom
That's not a verb I recognise.

>examine bottom
A suspicious removable panel at the bottom of the wardrobe.

Behind the false bottom, you discover a small locked safe.

* * *

>examine safe
A small metal safe hidden behind the false bottom.

>west
You have entered the Entrance Hall.

>south
You have entered the Living Room.

>search wife
You carefully search her and find a small key hidden in her pocket.

>north
You have entered the Entrance Hall.

>east
You have entered the Bedroom.

>unlock safe with key
(the safe key with the safe key)
That doesn't seem to be something you can unlock.

>examine wardrobe
A large wardrobe filled with expensive clothes.

As you examine the wardrobe more carefully, you notice a suspicious false bottom.

* * *

>examine bottom
A suspicious removable panel at the bottom of the wardrobe.

Behind the false bottom, you discover a small locked safe.

>unlock safe with key
(the safe key with the safe key)
That doesn't seem to be something you can unlock.

* * *

>examine wardrobe
A large closed wardrobe.

>examine bottom
The wardrobe is closed. You need to open it first.

>examine safe
A small metal safe hidden behind the false bottom.

>open safe
It seems to be locked.

>west
You have entered the Entrance Hall.

* * *

>north
You have entered the Entrance Hall.

>unlock safe with key
That doesn't seem to be something you can unlock.

>east
You have entered the Bedroom.

* * *

>examine wardrobe
A large closed wardrobe.

>examine false bottom
A suspicious removable panel at the bottom of the wardrobe.

Behind the false bottom, you discover a small locked safe.

>examine safe
A small metal safe hidden behind the false bottom.

* * *

>west
You have entered the Entrance Hall.

>look
Entrance Hall
You are standing in the entrance hall of the house. Doors lead to rooms on both sides of the corridor, and a staircase at the far end leads down to the basement.

* * *

>examine wardrobe
A large closed wardrobe.

>open wardrobe
You open the wardrobe.

>examine wardrobe
A large open wardrobe filled with expensive clothes.
As you examine the wardrobe more carefully, you notice a suspicious false bottom.

>examine bottom
A suspicious removable panel at the bottom of the wardrobe.

Behind the false bottom, you discover a small locked safe.

* * *

>examine safe
A small metal safe hidden behind the false bottom.

>open safe
The safe is locked. You need a key to open it.

* * *

>look
Bedroom
The bedroom is neat and carefully arranged. A bed stands in the center, with a nightstand beside it and a large wardrobe against the wall.

You can see a nightstand (closed) and a wardrobe (closed) here.

>examine bed
A large, neatly made bed. It looks untouched.

>examine nightstand
A small wooden nightstand.

>open nightstand
You open the nightstand, revealing a conspiracy book.

>examine book
A book titled "Top 10 Conspiracy Theories of the Last 50 Years". Many pages are bookmarked.

* * *

>look
Bedroom
The bedroom is neat and carefully arranged. A bed stands in the center, with a nightstand beside it and a large wardrobe against the wall.

You can see a nightstand (closed) and a wardrobe (closed) here.

>examine nightstand
A small wooden nightstand.

>open nightstand
You open the nightstand, revealing a book.

>examine book
A book titled "Top 10 Conspiracy Theories of the Last 50 Years". Many pages are bookmarked.

>examine wardrobe
A large wardrobe filled with expensive clothes.

As you examine the wardrobe more carefully, you notice a suspicious false bottom.

>look
Bedroom
The bedroom is neat and carefully arranged. A bed stands in the center, with a nightstand beside it and a large wardrobe against the wall.

You can see a nightstand (in which is a book) and a wardrobe (closed) here.

>examine false bottom
You can't see any such thing.

>examine wardrobe
A large wardrobe filled with expensive clothes.

As you examine the wardrobe more carefully, you notice a suspicious false bottom.

>examine false bottom
You can't see any such thing.

* * *

>east
You have entered the Bedroom.

>search son
You search the son, but find nothing except nervous tension.

>west
You have entered the Entrance Hall.

>west
You have entered the Bathroom.

>search maid
As you move closer to search her, her expression changes instantly. Panic flashes in her eyes.
Before you can react, she pulls out a hidden knife and lunges at you.

    *** Your investigation ends here. ***

Would you like to RESTART, RESTORE a saved game, QUIT or UNDO the last command?

>RESTART
A violent storm rages outside. POLICE REPORT (confidential): Mr. Blackwood, a wealthy businessman, has been murdered. The crime took place inside his house. Several people were present at the time of the incident. Your task is to uncover the truth.

Murder Mystery
An Interactive Fiction by Luka Hrupec
Release 1 / Serial number 251224 / Inform 7 v10.1.2 / D

Entrance Hall
You are standing in the entrance hall of the house. Doors lead to rooms on both sides of the corridor, and a staircase at the far end leads down to the basement.

>north
You have entered the Kitchen.

>search cook
You search the cook, but find nothing relevant to the case.

>south
You have entered the Entrance Hall.

>south
You have entered the Living Room.

* * *

>east
You have entered the Bedroom.

>examine wardrobe
A large wardrobe filled with expensive clothes.

As you examine the wardrobe more carefully, you notice a suspicious false bottom.

* * *

>examine bottom
A suspicious removable panel at the bottom of the wardrobe.

Behind the false bottom, you discover a small locked safe.

>open safe
(the safe key)
It isn't something you can open.

* * *

>east
You have entered the Bedroom.

>west
You have entered the Entrance Hall.

* * *

>open wardrobe
You open the wardrobe.

>examine wardrobe
A large closed wardrobe.

As you examine the wardrobe more carefully, you notice a suspicious false bottom.

>examine bottom
A suspicious removable panel at the bottom of the wardrobe.

Behind the false bottom, you discover a small locked safe.

>examine safe
(the safe key)
A small brass key. It looks like it could open a safe.

>unlock safe with key
(the safe key with the safe key)
That doesn't seem to be something you can unlock.

* * *

A violent storm rages outside. POLICE REPORT (confidential): Mr. Blackwood, a wealthy businessman, has been murdered. The crime took place inside his house. Several people were present at the time of the incident. Your task is to uncover the truth.

Murder Mystery
An Interactive Fiction by Luka Hrupec
Release 1 / Serial number 251228 / Inform 7 v10.1.2 / D

Entrance Hall
You are standing in the entrance hall of the house. Doors lead to rooms on both sides of the corridor, and a staircase at the far end leads down to the basement.

>look
Entrance Hall
You are standing in the entrance hall of the house. Doors lead to rooms on both sides of the corridor, and a staircase at the far end leads down to the basement.

>west
Bathroom
The bathroom is small and tidy. Everything appears normal at first glance.

>look
Bathroom
The bathroom is small and tidy. Everything appears normal at first glance.

>east
Entrance Hall
You are standing in the entrance hall of the house. Doors lead to rooms on both sides of the corridor, and a staircase at the far end leads down to the basement.

>south
You can't go that way.

>up
You can't go that way.

>down
Basement
The basement is cold and dim. A fuse box is mounted on the wall.

>up
Entrance Hall
You are standing in the entrance hall of the house. Doors lead to rooms on both sides of the corridor, and a staircase at the far end leads down to the basement.

>east
Bedroom
The bedroom is quiet and orderly. Too quiet.

* * *

A violent storm rages outside. POLICE REPORT (confidential): Mr. Blackwood, a wealthy businessman, has been murdered. The crime took place inside his house. Several people were present at the time of the incident. Your task is to uncover the truth.

Murder Mystery
An Interactive Fiction by Luka Hrupec
Release 1 / Serial number 251228 / Inform 7 v10.1.2 / D

Entrance Hall
You are standing in the entrance hall of the house. Doors lead to rooms on both sides of the corridor, and a staircase at the far end leads down to the basement.

>north
You have entered the Kitchen.

>accuse cook
You cannot accuse the Cook without questioning them first.

>ask cook about knife
Two knives went missing some time ago," the cook admits. "I noticed it during the renovation. Anyone could have taken them."

>accuse cook
The cook shakes his head slowly. "I've served this family for years. I would never do this."

>ask cook about blackwood
The Cook ignores your questions.

* * *

>north
You have entered the Kitchen.

>ask cook about knife
Two knives went missing some time ago," the cook admits. "I noticed it during the renovation. Anyone could have taken them."

>look
Kitchen
The kitchen looks disturbed. Edward Blackwood lies motionless on the floor, a knife stuck in his back. A cook is also present in the room, visibly shaken by the scene. You notice a refrigerator, an oven, a kitchen table, spice cabinets and a knife rack on the wall.

You can see a Cook here.

>examine knife
A kitchen knife covered in dried blood. It looks like it came from the cook's knife rack.

>ask cook about knife
The cook glances at the body. "Yes," he says quietly. "That knife is one of mine. It went missing during the renovation. I mentioned it back then, but nothing came of it."

* * *

>north
You have entered the Kitchen.

>look
Kitchen
The kitchen looks disturbed. Edward Blackwood lies motionless on the floor, a knife stuck in his back. A cook is also present in the room, visibly shaken by the scene. You notice a refrigerator, an oven, a kitchen table, spice cabinets and a knife rack on the wall.

You can see a Cook here.

>ask cook
(for the Cook)
(the Cook first taking the Cook)
The Cook has better things to do.

>talk to the cook
The cook wipes his hands on his apron. "I've worked here for years," he says. "I would never hurt Mr. Blackwood. This whole thing is a nightmare."

>ask cook about wife
"Mrs. Blackwood was under a lot of stress," he says carefully. "They argued often. But that's not my business."

>ask cook about blackwood
The cook shrugs. "I don't really know anything about that."

>ask cook about knife
Two knives went missing some time ago," the cook admits. "I noticed it during the renovation. Anyone could have taken them."

>south
You have entered the Entrance Hall.

>west
You have entered the Bathroom.

>examine bath
You can't see any such thing.

>look
Bathroom
The bathroom is small and tidy. A bathtub stands against the wall, next to a toilet and a towel rack. Everything appears normal at first glance. A maid stands near the bathtub, as if she was interrupted while cleaning.

You can see a bathroom cabinet (closed) and a Maid here.

>examine bathtub
A standard bathtub.

Upon closer inspection, you notice a small dried blood stain near the bathtub.

>ask maid about blackwood
She hesitates and avoids your gaze. "Mr. Blackwood was... unusual," she says softly. "Very cautious. Always watching, always suspecting something." She pauses. "He trusted very few people."

>notes
CASE NOTES:
- Victim found in the kitchen, stabbed with a kitchen knife.
- Blood was found in the bathroom, away from the crime scene.
- The maid seems to be hiding something.

>accuse maid
The maid stiffens. "You're wrong," she says coldly. "I have nothing more to say."

>arrest maid
As you move to arrest her, panic flashes in the maid's eyes.
A hidden knife appears in a blur of motion.

    *** CASE FAILED

You underestimated her.

The investigation ends in blood. ***

Would you like to RESTART, RESTORE a saved game, QUIT or UNDO the last command?

* * *

>ask cook
(for the Cook)
(the Cook first taking the Cook)
The Cook has better things to do.

>talk to cook
The cook wipes his hands on his apron. "I've worked here for years," he says. "I would never hurt Mr. Blackwood. This whole thing is a nightmare."

>ask cook about blackwood
The cook shrugs. "I don't really know anything about that."

* * *

>ask cook about knife
Two knives went missing some time ago," the cook admits. "I noticed it during the renovation. Anyone could have taken them."

>examine oven
A modern oven. It is turned off.

* * *

>look
Kitchen
The kitchen looks disturbed. Edward Blackwood lies motionless on the floor, a knife stuck in his back. A cook is also present in the room, visibly shaken by the scene. You notice a refrigerator, an oven, a kitchen table, spice cabinets and a knife rack on the wall.

You can see a Cook here.

>examine body
Mr. Blackwood lies motionless on the floor. There is a knife stuck in his back.

>examine knife
A kitchen knife covered in dried blood. It looks like it came from the cook's knife rack.

>take knife
You should not disturb the body any further.

>examine fridge
A large refrigerator. Nothing unusual.

>examine oven
A modern oven. It is turned off.

>examine table
A heavy wooden kitchen table.

>examine spice
Cabinets filled with various spices.

* * *

>look
Kitchen
The kitchen looks disturbed. Edward Blackwood lies motionless on the floor, a knife stuck in his back. A cook is also present in the room, visibly shaken by the scene. You notice a refrigerator, an oven, a kitchen table, spice cabinets and a knife rack on the wall.

You can see a Cook here.

>south
You have entered the Entrance Hall.

* * *

>west
You have entered the Bathroom.

>look
Bathroom
The bathroom is small and tidy. A bathtub stands against the wall, next to a toilet and a towel rack. Everything appears normal at first glance.

You can see a bathroom cabinet (closed) and a Maid here.

* * *

>look
Kitchen
The kitchen looks disturbed. Edward Blackwood lies motionless on the floor, a knife stuck in his back. A cook is also present in the room, visibly shaken by the scene. You notice a refrigerator, an oven, a kitchen table, spice cabinets and a knife rack on the wall.

You can see a Cook here.

>talk to cook
The cook wipes his hands on his apron. "I've worked here for years," he says. "I would never hurt Mr. Blackwood. This whole thing is a nightmare."

* * *

>north
You have entered the Kitchen.

>notes
CASE NOTES:
You have not gathered any solid notes yet.

>look
Kitchen
The kitchen looks disturbed. Edward Blackwood lies motionless on the floor, a knife stuck in his back. A cook is also present in the room, visibly shaken by the scene. You notice a refrigerator, an oven, a kitchen table, spice cabinets and a knife rack on the wall.

You can see a Cook here.

>examine rack
A wooden rack used to store kitchen knives.

You notice that two knives are missing from the rack.

>notes
CASE NOTES:
- Victim found in the kitchen, stabbed with a kitchen knife.
- Two knives are missing from the kitchen rack.

* * *

>north
You have entered the Kitchen.

>south
You have entered the Entrance Hall.

>look
Entrance Hall
You are standing in the entrance hall of the house. Doors lead to rooms on both sides of the corridor, and a staircase at the far end leads down to the basement.

>north
You have entered the Kitchen.

>east
You can't go that way.

>south
You have entered the Entrance Hall.

* * *

>look
Entrance Hall
You are standing in the entrance hall of the house. Doors lead to rooms on both sides of the corridor, and a staircase at the far end leads down to the basement.

>examine
What do you want to examine?

>east
You see nothing unexpected in that direction.

>east
You have entered the Bedroom.

>look
Bedroom
The bedroom is neat and carefully arranged. A bed stands in the center, with a nightstand beside it and a large wardrobe against the wall. The son of Mr. Blackwood stands in the room, looking tense and restless.

You can see a nightstand (closed), a wardrobe (closed) and a Son here.

>examine bed
A large, neatly made bed. It looks untouched.

>examine night stand
You can't see any such thing.

>examine nightstand
A small wooden nightstand.

* * *

>examine book
A book titled "Top 10 Conspiracy Theories of the Last 50 Years". Many pages are bookmarked.

>west
You have entered the Entrance Hall.

Thunder rumbles loudly outside. The storm shows no sign of stopping.

* * *

>west
You have entered the Bathroom.

>ask maid about blackwood
She hesitates and avoids your gaze. "Mr. Blackwood was... unusual," she says softly. "Very cautious. Always watching, always suspecting something." She pauses. "He trusted very few people."

>accuse maide
You can't see any such thing.

* * *

A violent storm rages outside. POLICE REPORT (confidential): Mr. Blackwood, a wealthy businessman, has been murdered. The crime took place inside his house. Several people were present at the time of the incident. Your task is to uncover the truth.

Murder Mystery
An Interactive Fiction by Luka Hrupec
Release 1 / Serial number 251228 / Inform 7 v10.1.2 / D

Entrance Hall
You are standing in the entrance hall of the house. Doors lead to rooms on both sides of the corridor, and a staircase at the far end leads down to the basement.

>notes
CASE NOTES:
You have not gathered any solid notes yet.

>north
You have entered the Kitchen.

>ask cook about wife
"Mrs. Blackwood was under a lot of stress," he says carefully. "They argued often. But that's not my business."

>notes
CASE NOTES:
- The cook just seems genuinely frightened.

>look
Kitchen
The kitchen looks disturbed. Edward Blackwood lies motionless on the floor, a knife stuck in his back. A cook is also present in the room, visibly shaken by the scene. You notice a refrigerator, an oven, a kitchen table, spice cabinets and a knife rack on the wall.

You can see a Cook here.

>notes
CASE NOTES:
- Victim found in the kitchen, stabbed with a kitchen knife.
- The cook just seems genuinely frightened.

* * *

>look
Kitchen
The kitchen looks disturbed. Edward Blackwood lies motionless on the floor, a knife stuck in his back. A cook is also present in the room, visibly shaken by the scene. You notice a refrigerator, an oven, a kitchen table, spice cabinets and a knife rack on the wall.

You can see a Cook here.

>notes
CASE NOTES:
- Victim found in the kitchen, stabbed with a kitchen knife.

* * *

A violent storm rages outside. POLICE REPORT (confidential): Mr. Blackwood, a wealthy businessman, has been murdered. The crime took place inside his house. Several people were present at the time of the incident. Your task is to uncover the truth.

Murder Mystery
An Interactive Fiction by Luka Hrupec
Release 1 / Serial number 251228 / Inform 7 v10.1.2 / D

Entrance Hall
You are standing in the entrance hall of the house. Doors lead to rooms on both sides of the corridor, and a staircase at the far end leads down to the basement.

>south
You have entered the Living Room.

>ask wife about safe
She shakes her head. "I don't know anything about that."

>north
You have entered the Entrance Hall.

* * *

>examine bottom
A suspicious removable panel at the bottom of the wardrobe.

Behind the false bottom, you discover a small locked safe.

>open safe
The safe is locked. You need a key to open it.

>west
You have entered the Entrance Hall.

* * *

>south
You have entered the Living Room.

>ask wife about safe
"I knew there was a safe," she admits quietly. "He never told me where it was, or what was inside. Our son was far more interested in it than I ever was."

* * *

>south
You have entered the Living Room.

>examine sofra
You can't see any such thing.

>examine sofa
A comfortable-looking sofa.

>look
Living Room
The living room is spacious and tastefully furnished. A sofa and a coffee table sit in the center of the room. A large cabinet stands against one wall.

You can see a living room cabinet (closed) here.

>examine coffee table
A low table with a few magazines on it.

>examine cabinet
A large wooden cabinet.

>open cabinet
You open the living room cabinet.

>search cabinet
You search the cabinet but find nothing of interest.

* * *

>south
You have entered the Living Room.

>north
You have entered the Entrance Hall.

* * *

>east
You have entered the Bedroom.

>examine safe
A small metal safe hidden behind the false bottom.

* * *

>east
You have entered the Bedroom.

>open safe
(the safe key)
It isn't something you can open.

>open safe with key
(the safe key with the safe key)
That doesn't seem to be something you can unlock.

>unlock safe with key
(the safe key with the safe key)
That doesn't seem to be something you can unlock.

* * *

>examine bottom
A suspicious removable panel at the bottom of the wardrobe.

Behind the false bottom, you discover a small locked safe.

>examine safe
(the safe key)
A small metal key. It looks like it could open a safe.

>open safe
(the safe key)
It isn't something you can open.

* * *

>south
You have entered the Living Room.

>seach wife
That's not a verb I recognise.

>search wife
You carefully search her and find a small key hidden in her pocket.

* * *

>east
You have entered the Bedroom.

>examine wardrobe
A large wardrobe filled with expensive clothes.

>open wardrobe
You open the wardrobe.

>examin wardrobe
That's not a verb I recognise.

>examine wardrobe
A large wardrobe filled with expensive clothes.

As you examine the wardrobe more carefully, you notice a suspicious false bottom.

>examin bottom
That's not a verb I recognise.

* * *

>examine wardrobe
A large closed wardrobe.

>examine bottom
A suspicious removable panel at the bottom of the wardrobe.

Behind the false bottom, you discover a small locked safe.

* * *

>examine safe
(the safe key)
A small metal key. It looks like it could open a safe.

>unlock safe with key
(the safe key with the safe key)
That doesn't seem to be something you can unlock.

* * *

>examine safe
A small metal safe hidden behind the false bottom.

>unlock safe with key
You unlock the safe with the key. It opens with a quiet click.

>open safe
You open the safe, revealing a bundle of cash, a conspiracy books and a love letter.

>examine cash
A thick bundle of banknotes. Someone was clearly preparing for something.

>examine books
Several books about secret societies, surveillance, and hidden plots. They seem heavily used.

>examine love letter
The letter speaks of secret meetings and forbidden affection. The writer dreams of escaping together, leaving this house behind forever. The letter is not signed.

* * *

>examine bottom
A suspicious removable panel at the bottom of the wardrobe.

Behind the false bottom, you discover a small locked safe.

>unlock safe with key
You unlock the safe with the key. It opens with a quiet click.

* * *

>open safe
You open the safe, revealing a bundle of cash, a conspiracy books and a love letter.

>examine love letter
The letter speaks of secret meeting and forbidden affection. The writer dreams of escaping together, leaving all of this behind forever. The letter is not signed, but clearly written by a lover.

>read love letter
The letter speaks of secret meeting and forbidden affection. The writer dreams of escaping together, leaving all of this behind forever. The letter is not signed, but clearly written by a lover.

>west
You have entered the Entrance Hall.

* * *

>west
You have entered the Bathroom.

>ask maid about wife
The maid lowers her voice. "She was very emotional. Watching everyone. I tried to stay invisible."

* * *

A violent storm rages outside. POLICE REPORT (confidential): Mr. Blackwood, a wealthy businessman, has been murdered. The crime took place inside his house. Several people were present at the time of the incident. Your task is to uncover the truth.

Murder Mystery
An Interactive Fiction by Luka Hrupec
Release 1 / Serial number 251228 / Inform 7 v10.1.2 / D

Entrance Hall
You are standing in the entrance hall of the house. Doors lead to rooms on both sides of the corridor, and a staircase at the far end leads down to the basement.

>west
You have entered the Bathroom.

* * *

>ask maid about wife
The maid lowers her voice. "She was very emotional. Watching everyone. I tried to stay invisible."

>accuse maid
The maid stiffens. "You're wrong," she says coldly. "I have nothing more to say."

>search maid
As you move closer to search her, her expression changes instantly. Panic flashes in her eyes.
Before you can react, she pulls out a hidden knife and lunges at you.

    *** Your investigation ends here. ***

Would you like to RESTART, RESTORE a saved game, QUIT or UNDO the last command?

>restart
A violent storm rages outside. POLICE REPORT (confidential): Mr. Blackwood, a wealthy businessman, has been murdered. The crime took place inside his house. Several people were present at the time of the incident. Your task is to uncover the truth.

Murder Mystery
An Interactive Fiction by Luka Hrupec
Release 1 / Serial number 251224 / Inform 7 v10.1.2 / D

Entrance Hall
You are standing in the entrance hall of the house. Doors lead to rooms on both sides of the corridor, and a staircase at the far end leads down to the basement.

>south
You have entered the Living Room.

* * *

>east
You have entered the Bedroom.

>open wardrobe
You open the wardrobe.

* * *

>open safe
You open the safe, revealing a bundle of cash, a conspiracy books and a love letter.

>read letter
The letter speaks of secret meeting and forbidden affection. The writer dreams of escaping together, leaving all of this behind forever. The letter is not signed, but clearly written by a lover.

>west
You have entered the Entrance Hall.

* * *

>ask maid about wife
The maid lowers her voice. "She was very emotional. Watching everyone. I tried to stay invisible."

>accuse maid
The maid freezes. Her shoulders slump.
"We were going to leave together," she whispers. "He promised me."
"Then he changed his mind. I was hurt. Angry. I never meant for this to happen."

>arrest maid
The case has reached its conclusion.

* * *

>open safe
You open the safe, revealing a bundle of cash, a conspiracy books and a love letter.

>examine letter
The letter speaks of secret meeting and forbidden affection. The writer dreams of escaping together, leaving all of this behind forever. The letter is not signed, but clearly written by a lover.

>west
You have entered the Entrance Hall.

* * *

>ask maid about wife
The maid lowers her voice. "She was very emotional. Watching everyone. I tried to stay invisible."

>search maid
As you move closer to search her, her expression changes instantly. Panic flashes in her eyes.
Before you can react, she pulls out a hidden knife and lunges at you.

    *** Your investigation ends here. ***

Would you like to RESTART, RESTORE a saved game, QUIT or UNDO the last command?

>undo
Bathroom
[Previous turn undone.]

>accuse maid
The maid breaks down completely. Tears run down her face as officers take her away.
"I loved him," she sobs. "We planned everything. To leave this place. To start over together."
She shakes her head in despair.
"But he changed his mind. He was afraid. Afraid of losing control. Afraid of what people would say."
"I didn't plan to kill him. It was rage, love, pain… all at once. I just snapped."

>arrest
(the Maid)

    *** CASE CLOSED

Against all odds, you uncovered the truth.

The murderer is arrested.

Justice, though imperfect, has been served. ***

Would you like to RESTART, RESTORE a saved game, QUIT or UNDO the last command?

* * *

>west
You have entered the Bathroom.

>examine bathtub
A standard bathtub.

Upon closer inspection, you notice a small dried blood stain near the bathtub.

>look
Bathroom
The bathroom is small and tidy. A bathtub stands against the wall, next to a toilet and a towel rack. Everything appears normal at first glance.

You can see a blood stain and a bathroom cabinet (closed) here.

* * *

>west
You have entered the Bathroom.

>leave
Now is not the time to leave. You should return to the entrance hall first.

>east
You have entered the Entrance Hall.

>leave
*** You decide to leave the house. The case will remain unsolved. ***

Would you like to RESTART, RESTORE a saved game, QUIT or UNDO the last command?

* * *

>west
You have entered the Bathroom.

>look
Bathroom
The bathroom is small and tidy. A bathtub stands against the wall, next to a toilet and a towel rack. Everything appears normal at first glance. A maid stands near the bathtub, as if she was interrupted while cleaning.

You can see a bathroom cabinet (closed) and a Maid here.

>examine toilet
A clean white toilet. Nothing unusual about it.

>examine towel rack
A metal rack holding neatly folded towels.

>examine bathtub
A standard bathtub.

Upon closer inspection, you notice a small dried blood stain near the bathtub.

>look
Bathroom
The bathroom is small and tidy. A bathtub stands against the wall, next to a toilet and a towel rack. Everything appears normal at first glance.

You can see a bathroom cabinet (closed) here.

>examine blood stain
A small dried blood stain near the edge of the bathtub.

>look
Bathroom
The bathroom is small and tidy. A bathtub stands against the wall, next to a toilet and a towel rack. Everything appears normal at first glance.

You can see a bathroom cabinet (closed) here.

>examine cabinet
A small wall-mounted cabinet.

>open cabinet
You open the bathroom cabinet, revealing a nerve pills.

>look in cabinet
In the bathroom cabinet is a nerve pills.

>examine pills
Prescription nerve pills. The label clearly shows the name of Mr. X's wife.

* * *

>look
Bathroom
The bathroom is small and tidy. A bathtub stands against the wall, next to a toilet and a towel rack. Everything appears normal at first glance. A maid stands near the bathtub, as if she was interrupted while cleaning.

You can see a bathroom cabinet (closed) and a Maid here.

>south
You can't go that way.

>east
You have entered the Entrance Hall.

>north
You have entered the Kitchen.

* * *

>south
You have entered the Living Room.

>look
Living Room
The living room is spacious and tastefully furnished. A sofa and a coffee table sit in the center of the room. Mr. Blackwood's wife is here, pacing nervously across the room. A large cabinet stands against one wall.

You can see a living room cabinet (closed) and a Wife here.

* * *

>look
Bathroom
The bathroom is small and tidy. A bathtub stands against the wall, next to a toilet and a towel rack. Everything appears normal at first glance. A maid stands near the bathtub, as if she was interrupted while cleaning.

You can see a bathroom cabinet (closed) and a Maid here.

>talk to maid
"Oh! I didn't hear you come in," the maid says nervously. "I was just cleaning the bathroom. I try to stay out of everyone's way."

>ask maid about blackwood
She hesitates and avoids your gaze. "Mr. Blackwood was... unusual," she says softly. "Very cautious. Always watching, always suspecting something." She pauses, as if remembering something personal, then adds, "He trusted very few people."

>ask maid about power
"I was in the bathroom when the lights went out," the maid says. "Everything went dark all of a sudden. I stayed where I was."

>ask maid about wife
The maid lowers her voice. "She was very emotional. Always on edge. I tried to stay out of her way."

>ask maid about strange
She shifts uncomfortably. "There was a lot of tension in the house lately," she says. "Arguments. Whispering. It didn't feel right."

>ask maid about šule
She shakes her head. "I'm not sure I can help you with that."

* * *

>west
You have entered the Bathroom.

>west
You can't go that way.

>east
Entrance Hall
You are standing in the entrance hall of the house. Doors lead to rooms on both sides of the corridor, and a staircase at the far end leads down to the basement.

>west
Bathroom
The bathroom is small and tidy. Everything appears normal at first glance.

>south
Kitchen
The kitchen looks disturbed. Something terrible has happened here.

>north
Bathroom
The bathroom is small and tidy. Everything appears normal at first glance.

>west
You can't go that way.